D391795553
BAAC56953A
86C1796D42
C3FAFAFFFA
BAFEF857FA
86FFFAFFFA
C53BFAFD52
B96AFAFFFA
AAD03A957A
C456C6C556

1,1
9,9