D5553D5153
B953C556BA
A878555546
AAFAFBFFFB
86FEF857FA
ABFFFAFFFA
AC17FAFD52
C3C3FAFFFA
BC3C505552
C54556D556

1,1
9,3
SSSWSSSESEEEEEEEENNNNN