D39393B913
BC6AAC6AAE
853AA956C3
ABC6847952
C43D695696
93A93C13AB
AAAAC3EAC2
AAC6BC3C3A
AC5147A96A
C57C5546D6
