D5395553
D3A85796
92AE93C3
AEA96C56
856C5553
A9395396
AAAABAC3
C6C6C456
