D5553D13
9557C3AE
85555683
AD13956A
A96AA956
AC3AEC53
C3AC393A
D46D46C6
