B913D5513B
AEAC553AC6
C569516C53
97FAFAFFFA
83FEF857FA
EAFFFAFFFA
943BFAFD52
AD42FAFFFA
853C7C393A
C7C55546C6

1,1
9,4
NEESSEESSSSSSESEEENNNNN